af - Afrikaans
sq - Albanian
ar - Arabic
hy - Armenian
bn - Bengali
bs - Bosnian
ca - Catalan
hr - Croatian
cs - Czech
da - Danish
nl - Dutch
en - English
eo - Esperanto
et - Estonian
fi - Finnish
fr - French
de - German
el - Greek
gu - Gujarati
ht - Haitian Creole
ha - Hausa
he - Hebrew
hi - Hindi
hu - Hungarian
is - Icelandic
id - Indonesian
it - Italian
ja - Japanese
jw - Javanese
kn - Kannada
km - Khmer
ko - Korean
la - Latin
lv - Latvian
lt - Lithuanian
lb - Luxembourgish
mk - Macedonian
ml - Malayalam
mn - Mongolian
mr - Marathi
my - Myanmar (Burmese)
ne - Nepali
no - Norwegian
or - Odia
ps - Pashto
fa - Persian
pl - Polish
pt - Portuguese
pa - Punjabi
ro - Romanian
ru - Russian
sm - Samoan
gd - Scottish Gaelic
sr - Serbian
st - Sesotho
sn - Shona
sd - Sindhi
si - Sinhala
sk - Slovak
sl - Slovenian
so - Somali
es - Spanish
su - Sundanese
sw - Swahili
sv - Swedish
tg - Tajik
ta - Tamil
te - Telugu
th - Thai
tr - Turkish
uk - Ukrainian
ur - Urdu
vi - Vietnamese
cy - Welsh
xh - Xhosa
yi - Yiddish
yo - Yoruba
zu - Zulu